-.-.-.-.-.-.-.-.-.
-.-.-.-.-.-.-.-.-.-
-.-.-.-.-.-.-.-.-.-
-.-.-.-.-.-.-.-.-.-
-.-.-.-.-.-.-.-.-.-
-.-.-.-.-.-.-.-.-.-
-.-.-.-.-.-.-.-.-.-
-.S.-.-.-.-.-.-.-.-
S.W.S.-.-.-.-.-.-.-
A.S.-.-.-.-.-.-.-.-
